##############
#  .   #     #
#   ####   ###
#      ##    #
#  #####    ##
#            #
##############