############################
#  .   #     #             #
#  #\####   ### ##    ######
#  #    ##    #  #  #      #
#  #####      # ##  #### # #
#                #     # # #
########  ########     # # #
#   ##    #  #   #  ####   #
#   #  #  #  #   #     #####
#      #       # #     \   #
########\#########    ######
#     #                  # #
#     #   #########   #    #
#  ####   #           # ####
#           ######         #
############################