################
#  .   #   /   #
#  #####   #####
#  /   ##      #
#  #####    ####
#           /  #
################