############################
#  .   #     #             #
#  # ####   ### ##    ######
#  #    ##    #  #  #      #
#  #####      # ##  #### # #
#                #     # # #
########  ########     # # #
#   ##    #  #   #  ####   #
#   #  #  #  #   #     #####
#      #       # #         #
######## #########    ######
#     #                  # #
#     #   #########   #    #
#  ####   #           # ####
#           ######         #
############################